Blackfeather	Druid
Xeda	Hunter
Sathanasxd	Paladin
Sneezi	Warrior
Karatelena	Priest
Skatie	Mage
Terryg	Shaman
Clark	Paladin
Unonna	Warlock
Kwiss	Hunter
Arthumesheal	Priest
Reggle	Priest
Xedinna	Hunter
Damaj	Shaman
Lolmannen	Warlock
Terittory	Druid
Ærza	Paladin
Sunshine	Rogue
Helvete	Warrior
Gorbis	Priest
Tå	Warlock
muphshaman	Shaman
Druidarniz	Druid
Xroads	Hunter
Phosil	Paladin
Shadowmary	Warlock
Tastywarr	Warrior
Bigdiqbandit	Hunter
Aikax	Druid
Lockmil	Warlock
Lyee	Druid
Hotbuses	Warrior
